+++++++++++++
+000000000000
+0000000*000+
+00000000000+
+00000000*00+
+00000000000+
M00000000000+
+++++++++++++
