+++++++++++
+0000000000
+000000*00+
+000000000+
+000*00*00+
+000000000+
M000*00000+
+++++++++++
